\[光 -> guang
\[土 -> tu
\[水 -> shui
アルディーン静時界 -> ardeen-temporal
アルヴェン海岸 -> arven-cove
イストリア光輝層 -> isutoriaguang-hui-ceng
イストリア輝教域 -> isutoriahui-jiao-yu
インシル火口域 -> insiruhuo-kou-yu
カディレア位相回廊 -> kateireawei-xiang-hui-lang
カディレア歪界 -> kateireawai-jie
カディレア歪界域 -> kateireawai-jie-yu
ギンデル水澱] -> kinterushui-dian
グリザリカ虚無域 -> kurisarikaxu-wu-yu
グリザリカ虚無帯 -> kurisarikaxu-wu-dai
シルファニル天空庭園 -> sylphanil-sky
シルファニル浮空帯 -> siruhuanirufu-kong-dai
セリカ湖岸林帯 -> serikahu-an-lin-dai
ゼーン丘陵地 -> senqiu-ling-di
ソレイア砂縁地 -> soreiasha-yuan-di
ソレイア砂縁地] -> soreiasha-yuan-di
ネレイア大海環 -> nereiada-hai-huan
ネレイア海原 -> nereiahai-yuan
ネレイア海域 -> nereiahai-yu
ミルザル断罪域 -> mirzar-dark
ムルネの湿地帯 -> murunenoshi-di-dai
ムルネの湿地帯] -> murunenoshi-di-dai
ラドゥナの滝 -> ratounanolong
ルマの陽だまり森 -> luma-glade
ロリールの浅い火口 -> rorirunoqian-ihuo-kou
ヴァストル岩隈帯 -> uasutoruyan-wei-dai
ヴァストル断層嶺 -> uasutoruduan-ceng-ling
ヴァストル断崖帯 -> uasutoruduan-ya-dai
光 -> hikari
土 -> tsuchi
変生獣 -> henseiju
時 -> toki
水 -> mizu
火 -> huo
無 -> mu
禁獣 -> kinju
空間 -> kuukan
精霊獣 -> seireiju
闇 -> yami
風 -> kaze
